***********
**!*** ****
** **  ****
**       **
****** ****
#      ****
***********