***********
**!*** ****
** **  ****
**       **
****** ****
*#     ****
***********
