**********
*#      **
******* **
*   *   **
* *   * **
* *****  *
*     ** *
* ***   **
*    ** !*
**********
