******************************************************************************************
*******************        *********************************        **********************
*****************   ******   *****************************   ******   ********************
****************  **********   *************************   **********  *******************
***************  *************  *********     *********  *************  ******************
**************  ***************  ****     ***     ****  ***************  *****************
************** *****************  *   ***********   *  ***************** *****************
************** ******************   ***************   ****************** *****************
************** ******************** **     ***     ** ****************** *****************
************** **********************  ***  *  ***  ******************** *****************
************** *********************  *****   *****  ******************* *****************
************** ********************* ******* ******* ******************* *****************
************** ********************* ******* ******* ******************* *****************
************** ********************* ******* ******* ******************* *****************
************** ********************* ******* ******* ******************* *****************
**************  ******************** **** ** ** **** ******************  *****************
*************** ******************** ***   * *   *** ****************** ******************
*************** ******************** *** *     * *** ****************** ******************
*************** *************** ****  **   ***   **  **** ************* ******************
*************** **************  ***** *** ***** *** *****  ************ ******************
***************  ************* ****** ************* ****** ***********  ******************
**************** ************  **     ****** ******     **  ********** *******************
**************** ************ *   ***    *** ***    ***   * ********** *******************
****************  **********    ********         ********    ********  *******************
*****************  *******   * **    *****  *  *****    ** *   *****  ********************
******************         *** **  *   ***********   *  ** ***       *********************
****************************** *   *******     *******   * *******************************
****************************** * * ******  ***  ****** * * *******************************
******************************   *  ***** ***** *****  * * *******************************
****************************** ****  ****  ***  ****  **** *******************************
******************************  ****  ****     ****  ****  *******************************
*******************************  ****  ***** *****  ****  ********************************
********************************  ****  **** ****  ****  *********************************
*********************************  ****     #     ****  **********************************
**********************************  *****************  ***********************************
***********************************  **************   ************************************
************************************        !       **************************************
******************************************* * ********************************************
******************************************* * ********************************************
******************************************  *  *******************************************
****************************************** *** *******************************************
****************************************** *** *******************************************
*****************************************  ***  ******************************************
***************************************** ***** ******************************************
***************************************** ***** ******************************************
***************************************** ***** ******************************************
*****************************************       ******************************************
******************************************************************************************
