***************
*           *!*
*#* ********  *
*   *   **** **
* **  * ***   *
*    **   *** *
** ***  *   * *
** **  ** *** *
**    ***     *
***************
