********************
*                 **
* ***** ********* **
* *   * ********* **
* * *   *#      *  *
* * *********** ** *
* * *** *!* **     *
* * *** * *  * * * *
* *     * ** * * * *
* ******* ** * * * *
*         **   *   *
********************
