*************************
*  *************        *
** *           * ****** *
*  * ****** **** *      *
* **      * **** ****** *
*  ****** *           * *
** **   * *********** * *
*   ** ** *           * *
* *    ** * *********** *
* ******* *     *     * *
*         * *** * *** * *
* ********* ********* * *
*#       *     !*       *
*************************
