******************************
*                           #*
************************ *****
*                            *
****** ***********************
*                            *
************* ****************
*                            *
*************************** **
*                            *
**** *************************
*                            *
**** *************************
*                           !*
******************************
