***********************************************************************
*    *    *    *    *    *    *    *    *    *    *    *    *    *    *
**** **** **** **** **** **** **** **** **** **** **** **** **** **** *
*  * *  * *  * *  * *  * *  * *  * *  * *  * *  * *  * *  * *  * *  * *
** * ** * ** * ** * ** * ** * ** * ** * ** * ** * ** * ** * ** * ** * *
* #                                                                   *
** * ** * ** * ** * ** * ** * ** * ** * ** * ** * ** * ** * ** * ** * *
*  * *  * *  * *  * *  * *  * *  * *  * *  * *  * *  * *  * *  * *  * *
**** **** **** **** **** **** **** **** **** **** **** **** **** **** *
*    *    *    *    *    *!   *    *    *    *    *    *    *    *    *
***********************************************************************
