*************************************************************************************
****************************************** ******************************************
*                                         #                                         *
**************************************** * **************************************** *
*                                      * * *                                      * *
* ************************************ * * * ************************************ * *
* *                                  * * * * *                                  * * *
* * ******************************** * * * * * ******************************** * * *
* * *                              * * * * * * *                              * * * *
* * * **************************** * * * * * * * **************************** * * * *
* * * *                          * * * * * * * * *                          * * * * *
* * * * ************************ * * * * * * * * * ************************ * * * * *
* * * * *                      * * * * * * * * * * *                      * * * * * *
* * * * * ******************** * * * * * * * * * * * ******************** * * * * * *
* * * * * *                    * * * * * * * * * * * *!                   * * * * * *
* * * * * ********************** * * * * * * * * * * ********************** * * * * *
* * * * *                        * * * * * * * * * *                        * * * * *
* * * * ************************** * * * * * * * * ************************** * * * *
* * * *                            * * * * * * * *                            * * * *
* * * ****************************** * * * * * * ****************************** * * *
* * *                                * * * * * *                                * * *
* * ********************************** * * * * ********************************** * *
* *                                    * * * *                                    * *
* ************************************** * * ************************************** *
*                                        * *                                        *
****************************************** ******************************************
*                                                                                   *
****************************************** ******************************************
*                                                                                   *
****************************************** ******************************************
*                                                                                   *
*************************************************************************************
